"filename", "language", "Python", "Markdown", "Log", "comment", "blank", "total"
"d:\year3\IN3007-IndividualProject\CameraMatrix.py", "Python", 47, 0, 0, 0, 4, 51
"d:\year3\IN3007-IndividualProject\GroupDetection.py", "Python", 77, 0, 0, 4, 31, 112
"d:\year3\IN3007-IndividualProject\HomographyMethod.py", "Python", 60, 0, 0, 0, 15, 75
"d:\year3\IN3007-IndividualProject\Main.py", "Python", 2, 0, 0, 0, 1, 3
"d:\year3\IN3007-IndividualProject\MatrixTransformation.py", "Python", 31, 0, 0, 1, 14, 46
"d:\year3\IN3007-IndividualProject\PythonApplication1\PythonApplication1\PythonApplication1.py", "Python", 87, 0, 0, 14, 42, 143
"d:\year3\IN3007-IndividualProject\README.md", "Markdown", 0, 2, 0, 0, 1, 3
"d:\year3\IN3007-IndividualProject\SDBoundingBox.py", "Python", 18, 0, 0, 2, 2, 22
"d:\year3\IN3007-IndividualProject\SDEstimatedCalibratedCamera.py", "Python", 30, 0, 0, 21, 14, 65
"d:\year3\IN3007-IndividualProject\SocialDistancing.py", "Python", 128, 0, 0, 32, 22, 182
"d:\year3\IN3007-IndividualProject\VideoPlayer.py", "Python", 133, 0, 0, 48, 75, 256
"d:\year3\IN3007-IndividualProject\report\report.log", "Log", 0, 0, 1191, 0, 97, 1288
"Total", "-", 613, 2, 1191, 122, 318, 2246