"filename", "language", "Python", "Markdown", "Log", "comment", "blank", "total"
"d:\year3\IN3007-IndividualProject\CameraMatrix.py", "Python", 47, 0, 0, 0, 4, 51
"d:\year3\IN3007-IndividualProject\GroupDetection.py", "Python", 18, 0, 0, 0, 10, 28
"d:\year3\IN3007-IndividualProject\HomographyMethod.py", "Python", 52, 0, 0, 0, 10, 62
"d:\year3\IN3007-IndividualProject\Main.py", "Python", 2, 0, 0, 0, 1, 3
"d:\year3\IN3007-IndividualProject\MatrixTransformation.py", "Python", 31, 0, 0, 1, 14, 46
"d:\year3\IN3007-IndividualProject\PythonApplication1\PythonApplication1\PythonApplication1.py", "Python", 87, 0, 0, 14, 42, 143
"d:\year3\IN3007-IndividualProject\README.md", "Markdown", 0, 2, 0, 0, 1, 3
"d:\year3\IN3007-IndividualProject\SDBoundingBox.py", "Python", 18, 0, 0, 2, 2, 22
"d:\year3\IN3007-IndividualProject\SDEstimatedCalibratedCamera.py", "Python", 30, 0, 0, 21, 14, 65
"d:\year3\IN3007-IndividualProject\SocialDistancing.py", "Python", 110, 0, 0, 52, 56, 218
"d:\year3\IN3007-IndividualProject\VideoPlayer.py", "Python", 117, 0, 0, 13, 22, 152
"d:\year3\IN3007-IndividualProject\report\report.log", "Log", 0, 0, 1066, 0, 59, 1125
"Total", "-", 512, 2, 1066, 103, 235, 1918